+------------------------------+
|             #                |
|             #           #    |
|             #           ##   |
|   #                          |
|   #                          |
|   ####                       |
|                              |
|                   #    *     |
|                   #          |
|                 #####        |
|         o         #          |
|                   #          |
|      ######                  |
|                          ##  |
|                           #  |
+------------------------------+
